###
# #       ###
# #       # #
# ######### ##############
#                       A#
####### ##################
      #B#
      ###
